NO   textures/NO.xpm
WE textures/WE.xpm
SO  textures/SO.xpm
EA  textures/EA.xpm
C 120,0,16
F 3,4,50

              0
               1
111111111111111111111111111
10000000000000000000N000001
100000000000000000000000001
111111111111111111111111111
