NO textures/NO.xpm   
SO textures/SO.xpm
EA textures/EA.xpm
WE textures/WE.xpm
        
F 164,169,20
C 35 ,78,0

1111111111111111111111111111111111111
1000000000000000000000000000000000001
1000000000000000000000000000000000001
1000000000000000000000000000000000001
1000000000000000000000000000000000001
1000011111111110000000000000000000001
100N000000000000000000000000000000001
1111111111111111111111111111111111111