NO textures/NO.xpm   
SO textures/SO.xpm
EA textures/EA.xpm
WE textures/WE.xpm
        
F 164,169,20
C 35 ,78,0

11111111
10000001
10000001
10000001
10000001
10000111
100N0001
11111111