NO textures/NO.xpm   
SO textures/SO.xpm
EA textures/EA.xpm
WE textures/WE.xpm
        
F 164,169,20
C 35 ,78,0

111111111111111111111111111111111111111111111111111111
100000000000000100000000000000000000000000000000000011
100000000000000D00000000000000000000000000000000000001
100000000011111111000000000000000000000000000000000001
100000000000000000000000000000000000000000000000000001
100000000000000000001110110000000000000000000000000001
100N00000000000000000000000000000000000000000000000001
111111111111111111111111111111111111111111111111111111