NO textures/NO.xpm   
SO textures/SO.xpm
WE textures/WE.xpm
EA textures/EA.xpm

C 153,1, 7  
F 1,1,5


111111111111111111111
100000001000000000001
100000001000000000001
100000001000000000001
100000001000000000001
100000000000000000011
100000000000000000001
100000000000000000001
100000000000000000001
1000100000W0010000001
100000000000000000011
100000001000000000001
111111111111111111111
1111111111111 1111111  1
1111111111111        1111
1111111111111111 1111
1111111111111111 1111
1   1  1 