NO textures/NO.xpm   
SO textures/SO.xpm
EA textures/EA.xpm
WE textures/WE.xpm
        
C 153,204,255   
F 164,169,20

111111111111111111111
100000001000000000001
100000001000000000001
100000001000000000001
100000001000000000001
100000000000000000001
100000000000000000001
100000000000000000001
10000000000S000000001
100000000000000000001
100000000000000000001
100000001000000000001
111111111111111111111