NO textures/NO.xpm
SO textures/SO.xpm
EA textures/EA.xpm
WE textures/WE.xpm

F 164,169,20
C 153,204,255

111111111111111111111
101000001000000000001
101010101011111110001
100010100010000010001
111111101111101011101
      100000000000001
      101011101111111
      101010100000101
111111111010111110101
101010001010100010101
101110101010101010101
100000101010001010001
111111101011111011101
100000101000100010001
101110101110101110111        111111111111111111
101000100000100010101        100000000000000001
101011111111111010101        100000000100000001
10001000000000001000111111111100000000100000001
10101011101111111110000000000000000000100000001
1N100000100000000000000000000000000000000000001
11111000000000111111111111111111111111111111111
111110000000001
111110000000001
    10000000001
    11000000001
    11100000001
      111111111 
