NO textures/NO.xpm
WE textures/WE.xpm
SO textures/SO.xpm
EA  textures/EA.xpm

F 0,32,0
F 0,32,0
C 120,0,16

111111111111111111111111111
1000000000000N0000000000001
100000000000000000000000001
111111111111111111111111111
011111111111111111111111111