NO textures/NO.xpm
WE textures/WE.xpm
SO textures/SO.xpm
EA textures/.xpm
C 120,0,16
F 3,4,50

111111111111111011111111111
111111111111111111111111111
10000000W000000000000000001
100000000000000000000000001
111111111111111111111111111