F 0,32,0

111111111111111111111111111
1000000000000N0000000000001
100000000000000000000000001
111111111111111111111111111
111111111111111111111111111

NO textures/NO.xpm
WE textures/WE.xpm
SO textures/SO.xpm
EA  textures/EA.xpm

C 120,0,16