NO     textures/NO.xpm
C        120,       0   ,16
WE   textures/WE.xpm


SO   textures/SO.xpm
F  0,        32, 0
EA          textures/EA.xpm

    111111111111111111111111111111111111111111111111111111
    1E0000000000000000000000000000000000000000000000000001
    100000000000000000000000000000000000000000000000000001
    111111111111111111111111111111111111111111111111111111
