           NO textures/NO.xpm
SO      textures/SO.xpm   

   
 EA      textures/EA.xpm
                       WE  textures/WE.xpm
            
 C 153,          204           ,255      
F 164,169 ,20

111111111111111111111
101000001000000000001
101010111111111110001
1Q001010W010000010001
111111111111111111111111111
1111111111Q1111111111111111