NO textures/NO.xpm
SO textures/SO.xpm
EA textures/EA.xpm
WE textures/WE.xpm

C 153,204,255

1111111111111111
1001000000000001
1101011111110001
1100010000010001
1000000000010001
1111011111111101
10N0000000000001
1111111111111111