NO textures/NO.xpm
SO textures/SO.xpm
EA textures/EA.xpm
WE textures/WE.xpm

F 164,169,20
C 153,204,255

111111111111111111111111
111101000001000000000001
111101010101011111110001
1000101000100000100011111111111
1111101011111010111000000000001
1000001010001010000000000000001
1011111010111011111111111111111
101000001010100000101
101011111010111110101
101010001010100010101
101110101010101010101
100000101010001010001
111111101011111011101
1000001010001S0010001
1011101011101011101111
1010001000001000101001
1010111111111110101001
1000100000000000100011
101010111011111111101
1N1000001000000000001
111111111111111111111
