NO textures/NO.xpm
SO textures/SO.xpm
EA textures/NO.xpm
WE textures/WE.xpm 

F 169,80,20
C 153,204,255

1111111111111111
1001000000000001
1101011111110001
110001000 001001
1000000000010011
1111011111111101N
1000000000000001
1111111111111111