NO textures/NO.xpm
SO textures/SO.xpm
EA textures/EA.xpm
WE textures/WE.xpm

F 127,0,255
C 204,103,255

        1111111111111111111111111
        1000000000110000000000001
        1011000001110000000000001
        1001000000000000000000001
111111111011000001110000000000001
100000000011000001110111110111111
11110111111111011100000010001
11111111111111111111111111011
11110111111111011101010010000
11000000110101011100000010000
10000000000000001100000010S00
10000000000000001101010010001
110000011111010111110111100111
11110111  1110101 101111010001
11111111  1111111 111111111111
