NO   textures/NO.xpm


WE textures/WE.xpm




SO  textures/SO.xpm
EA  textures/EA.xpm

F 0,32,0

C 120,0,16







         111111111 1111111111111 
        1000000000110000000000001
        1011000001110000000000001
        100100000000000S000000001
 11111111011000001110000000000001
10000000001100000111011111011111 
 1110111111111011100000010001
  110111111111011101010010001
 1000000110101011100000000001
10000000000000001100000010001
10000000000000001101010010001
1100000111010101111101111000111
11110111  110101 1011 1010001
    1       1 1   1    1 111 
