NO   textures/NO.xpm
WE textures/WE.xpm
SO  textures/SO.xpm
EA  textures/EA.xpm

F       0    ,  32,0
C           120, 10   ,  16

11      11      11
1 11    1 11    1 11 
1   11  1   11  1   11
1     1 1     1 1     1
1      1       1      1
 111111111111111111111
10000000000000000000001
1000011000S000011000001
10000110000000011000001
10000000001110000000001
10000000000000000000001
 111111111111111111111
