NO textures/NO.xpm
WE textures/WE.xpm
SO textures/SO.xpm
EA textures/.xpm
C 120,0,16
F 3,4,50

111111111111111111111111110
111111111111111111111111111
100000000000000000000000001
1000000000S0000000000000001
111111111111111111111111111